EN	SI
Greeting	Pozdravi
Hi!	Zdravo!
Good morning!	Dobro jutro
Good afternoon!	Dober dan
Good evening!	Dober večer
Welcome! (to greet someone)	Dobrodošli!
How are you? (friendly)	Kako ste kaj?
How are you? (polite)	Kako ste kaj?
I'm fine, thank you!	Dobro hvala!
Good	Dobro
Long time no see	Že dolgo se nisva videla
I missed you	Pogrešal sem te
What's new?	Kaj je novega?
Thank you (very much)!	Najlepša hvala
You're welcome! (for "thank you")	Ni za kaj
Come in! (or: enter!)	Vstopite
Farewell Expressions	Slovo
Good night!	Lahko noč!
Good bye!	Na svidenje!
I will be right back!	Takoj se vrnem
Holidays and Wishes	
Good luck!	Vso srečo!
Happy birthday!	Vse najboljše za rojstni dan
Happy new year!	Srečno novo leto
Merry Christmas!	Srečen božič
Congratulations!	Čestitam!
Bless you (when sneezing)	Na zdravje
How to Introduce Yourself	Kako se predstavimo
What's your name?	Kako vam je ime?
My name is (John Doe)	Moje ime je
Where are you from?	Od kod ste?
Where do you live?	Kje živite?
I live in (the U.S/ Slovenia)	Živim v (Ameriki/Sloveniji
Do you like it here?	Kako vam je všeč v …(sloveniji/Ameriki)
What do you do for a living?	Kakšen poklic opravljate?
I'm a (teacher/ student/ engineer)	Po poklicu sem (učitelj/študentz/inžiner)
Do you speak (English/ Slovene)?	Ali govorite (angleško/Slovensko)?
Just a little	Zelo slabo
I'm trying to learn Slovene	Poskušam se naučiti slovenskega jezika
It's a hard language	To je težek jezik
It's an easy language	To je lahek jezik
Oh! That's good!	Zelo dobro
Can I practice with you?	Lahko vadim z vami?
I will try my best to learn	Poskušal se bom naučiti po svojih najboljših močeh
How old are you?	Koliko ste stari?
I'm (twenty one, thirty two) years old	Star sem (enaindvajset, dvaintrideset) let
Mr.../ Mrs. .../ Miss...	G./Ga./Gospodična
This is my wife	To je moja soproga
This is my husband	To je moj mož
Romance and Love Phrases	Ljubezenske zadeve
Are you free tomorrow evening?	Ste jutri tvečer prosti?
I would like to invite you to dinner	Vas smem povabiti na večerjo?
You look beautiful! (to a woman)	Zelo lepi ste
You have a beautiful name	Imate zelo lepo ime
Can you tell me more about you?	Mi lahko poveste kaj več o sebi?
Are you married?	Ali ste poročeni ?
I'm single	Nisem poročen
I'm married	Poročen sem
Can I have your phone number?	Mi lahko zaupate svojo telefonsko številko?
Can I have your email?	MI lahko zaupate vaš elektronski poštni naslov?
Do you have any pictures of you?	Imate kako svojo sliko?
Do you have children?	Koiko otrok imate?
Would you like to go for a walk?	Ste za sprehod?
I like you	Všeč ste mi
I love you	Ljubim te
You're very kind!	Zelo ste prijazni
Would you marry me?	Bi se poročili z menoj?
I'm just kidding	Samo šalim se
My heart speaks the language of love	Moje srce govori jezik ljubezni
Solving a Misunderstanding	reševanje nesporazumov
Sorry! (or: I beg your pardon!)	Oprostite!
Can you repeat please?	Lahko ponovite?
Can you speak slowly?	Lahko govorite počasneje?
Can you write it down?	Mi lahko to napišete?
Did you understand what I said?	Ste razumeli kar sem povedal?
I don't understand!	Ne razumem!
I don't know!	Ne vem?
What's that called in Slovene?	Kako se temu reče po slovenskjo?
What does that word mean in English?	Kaj ta beseda pomeni v angleščini?
How do you say "thanks" in Slovene?	Kako v slovenščini rečete "hvala"?
What is this?	Kaj je to?
My Slovene is bad	Moja slovenščina je slaba
Don't worry!	Ne skrbite!
I agree with you	Strinjam se z vami
Is that right?	Je prav tako?
Is that wrong?	Je to narobe?
What should I say?	Kaj naj rečem?
I just need to practice	Moram vaditi
Your Slovene is good	Vaša slovenščina je dobra
I have an accent	Imam naglas
You don't have an accent	Nimate naglasa
Asking for Directions	Prošnje za pomoč in smer
Excuse me! (before asking someone)	Vas lahko zmotim?
I'm lost	Izgubil sem se
Can you help me?	Mi lahko pomagate?
Can I help you?	Vam lahko pomagam?
I'm not from here	Nisem od tu
How can I get to (this place, this city)?	Kako lahko pridem do tega (kraja, mesta)
Go straight	Pojdite naravnost
Then	nato
Turn left	zavijte levo
Turn right	zavijte desno
Can you show me?	Mi lahko pokažete?
I can show you!	Lahko vam pokažem!
Come with me!	Pojdite z menoj!
How long does it take to get there?	Koliko časa potrebujem do tam?
Downtown (city center)	Mestno središče
Historic center (old city)	zgodovinsko središče (staro mesto)
It's near here	To je blizu
It's far from here	To je daleč
Is it within walking distance?	Grem lahko peš do tja?
I'm looking for Mr. Smith	Iščem G. Smitha
One moment please!	Samo trenutek!
Hold on please! (when on the phone)	Samo trenutek prosim! (telefonski pogovor)
Airport	Letališče
Bus station	Avtobusna postaja
Train station	Želežniška postaja
Taxi	Taksi
Near	Blizu
Far	Daleč
Emergency Survival Phrases	Fraze, ki se uporabljajo v nujnih primerih in za preživetje
Help!	Na pomoč!
Stop!	Stoj!
Fire!	Ogenj!
Thief!	Tat!
Run!	Teci!
Watch out! (or: be alert!)	Pazi!
Call the police!	Pokličite policijo!
Call a doctor!	Pokličite zdravnika
Call the ambulance!	Pokličite reševalno vozilo!
Are you okay?	Ste v redu!
I feel sick	Bolan sem
I need a doctor	Potrebujem zdravnika
Accident	Nesreča
Food poisoning	Zastrupitev z hrano
Where is the closest pharmacy?	Kje je najbližja lekarna"
It hurts here	Tu me bnoli
It's urgent!	Nujno je
Calm down!	Pomirite se!
You will be okay!	Z vami je vse v redu!
Can you help me?	Mi lahko pomagate?
Can I help you?	Vam lahko vam pomagam?
Hotel Restaurant Travel Phrases	Fraze, ki se uporabljajo v hotelih in na potovanju
I have a reservation (for a room)	Imam rezervacijo
Do you have rooms available?	Imate kako prosto sobo?
With shower / With bathroom	z tušem/kopalnico
I would like a non-smoking room	Želel bi sobo za nekadilce
What is the charge per night?	Kakšna je cena za eno noč
I'm here on business /on vacation	Tu sem poslovno/ na počitnicah
Dirty	Umazan
Clean	Čist
Do you accept credit cards?	Ali sprejemate kreditne karte?
I'd like to rent a car	Želel bi najeti rent a car
How much will it cost?	Koliko stane?
A table for (one / two) please!	Mizo za (enega/dva) prosim!
Is this seat taken?	Je ta stol zaseden?
I'm vegetarian	Sem vegetarijanec
I don't eat pork	Ne jem svinjine
I don't drink alcohol	Ne pijem alkohola
What's the name of this dish?	Kako se imenuje ta jed?
Waiter / waitress!	Natakar/natakarica!
Can we have the check please?	Lahko dobim račun prosim?
It is very delicious!	To je zelo okusno
I don't like it	Tega ne maram
Shopping Expressions	Trgovski izrazi
How much is this?	Koliko stane?
I'm just looking	Samo gledam
I don't have change	Nimam drobiža
This is too expensive	To je predrago
Expensive	Drago
Cheap	Poceni
Daily Expressions	Naključni izrazi
What time is it?	Koliko je ura?
It's 3 o'clock	Ura je tri
Give me this!	Dajte mi to
Are you sure?	Ali ste prepričani?
Take this! (when giving something)	Vzemite
It's cold (weather)	Zelo mrzlo je
It's hot (weather)	Vroče je
Do you like it?	Vam je všeč?
I really like it!	Zelo mi je všeč!
I'm hungry	Lačen sem
I'm thirsty	Žejen sem
He is funny	Zabaven je
In The Morning	Zjutraj
In the evening	Zvečer
At Night	Ponoči
Hurry up!	Pohitite!
Cuss Words (polite)	
This is nonsense! (or: this is craziness)	To je neumnost
My God! (to show amazement)	Moj bog!
Are you crazy?	Si zmešan?
Get lost! (or: go away!)	Pojdi stran!
Leave me alone!	Pusti me pri miru!
I'm not interested!	Ne zanima me!
Writing a Letter	
My trip was very nice	Moje potovanje je bilo zelo prijetno
The culture and people were very interesting	Kultura in ljudje so zelo zanimivi
I had a good time with you	z vami sem se imel zelo lepo
Don't forget to write me back from time to time	Ne pozabi mi občasno pisati
Short Expressions and words	Kratke besede in izrazi
Good	Dobro
Bad	Slabo
So-so (or: not bad not good)	Povprečno _ which menas literary average, there is no equvalent expression for so-so in slov. lang.
Big	Veliko
Small	Majhno
Today	Danes
Now	Sedaj
Tomorrow	Jutri
Yesterday	Včeraj
Yes	Da
No	Ne
Fast	Hitro
Slow	Počasi
Hot	Vroče
Cold	Mrzlo
This	To
That	Ono
Here	Tu
There	Tam
Me (ie. Who did this? - Me)	Jaz
You	Ti
Him	On
Her	Ona
Us	Mi
Them	Oni
Really?	Resnično?
Look!	Poglej!
What?	Kaj?
Where?	Kje?
Who?	Kdo?
How?	Kako?
When?	Kdaj?
Why?	Zakaj?
Zero	Nič
One	Ena
Two	Dva
Three	Tri
Four	Štiri
Five	Pet
Six	Šest
Seven	Sedem
Eight	Osem
Nine	Devet
Ten	Deset
adjectives	pridevniki
a green tree	zeleno drevo
a tall building	visoka stavba
a very old man	zelo star moški
the old red house	stara rdeča hiša
a very nice friend	zelo prijazen prijatelj
colors	barve
black	črna
blue	modra
brown	rjava
gray	siva
green	zelena
orange	oranžna
purple	vijolična
red	rdeča
white	bela
yellow	rumena
sizes	velikosti
big	velik
deep	globok
long	dolgo
narrow	ozko
short	kratko
small	majhno
tall	visoko
thick	debel
thin	tanko
wide	široko
shapes	oblike
circular	okroglo
straight	ravno
square	kvadratno
triangular	trikotno
tastes	okusi
bitter	grenko
fresh	svež
salty	slan
sour	kisel
spicy	začinjeno
sweet	sladko
qualities	lastnosti
bad	slab
clean	čisto
dark	temen
difficult	težek
dirty	umazan
dry	suho
easy	enostavno
empty	prazno
expensive	drag
fast	hiter
foreign	tuje
full	celotno
good	dober
hard	trdo
heavy	težko
inexpensive	poceni
light	svetlo
local	lokalno
new	nov
noisy	hrupno
old	staro
powerful	močno
quiet	tiho
correct	pravilno
slow	počasen
soft	mehek
very	zelo
weak	šibko
wet	mokro
wrong	napačno
young	mlado
quantities	količine
few	malo
little	malo
many	veliko
much	veliko
part	del
some	nekaj
a few	nekaj
whole	celotno
numbers	števniki
one	ena
two	dva
three	tri
four	štiri
five	pet
six	šest
seven	sedem
eight	osem
nine	devet
ten	deset
eleven	enajst
twelve	dvanajst
thirteen	trinajst
fourteen	štirinajst
fifteen	petnajst
sixteen	šestnajst
seventeen	sedemnajst
eighteen	osemnajst
nineteen	devetnajst
twenty	dvajset
hundred	sto
one thousand	tisoč
million	milijon
Ordinal Numbers	Vrstilni števniki
first	prvi
second	drugi
third	tretji
fourth	četrti
fifth	peti
sixth	šesti
seventh	sedmi
eighth	osmi
ninth	deveti
tenth	deseti
eleventh	enajsti
twelfth	dvanajsti
thirteenth	trinajsti
fourteenth	štirinajsti
fifteenth	petnajsti
sixteenth	šestnajsti
seventeenth	sedemnajsti
eighteenth	osemnajsti
nineteenth	devetnajsti
twentieth	dvajseti
once	enkrat
twice	dvakrat
nouns	samostalniki
my car	moj avto
green car	zelen avto
three cars	trije avtomobili
car garage	garaža
outside the car	izven avtomobila
arm	roka
back	hrbet
cheeks	lica
chest	prsa
chin	brada
ear	uho
elbow	komolec
eye	oko
face	obraz
finger	prst
fingers	prsti
foot	stopalo
hair	lasje
hand	roka
head	glava
heart	srce
knee	koleno
leg	noga
lip	ustnica
mouth	usta
neck	vrat
nose	nos
shoulder	rama
stomach	trebuh
teeth	zobje
thigh	stegno
throat	grlo
thumb	palec
toe	nožni prst
tongue	jezik
tooth	zob
Vocabulary	Besedišče
Countries	Države
Australia	Avstralija
Cambodia	Kambodža
Canada	Kanada
China	Kitajska
Egypt	Egipt
England	Anglija
France	Francija
Germany	Nemčija
Greece	Grčija
India	Indija
Indonesia	Indonezija
Italy	Italija
Japan	Japonska
Mexico	Mehika
Morocco	Maroko
Peru	Peru
Spain	Španija
Thailand	Tajska
USA	ZDA
Languages	Jeziki
Arabic	Arabščina
Chinese	Kitajščina
English	angleščina
French	Francoščina
German	Nemščina
Greek	Grščina
Hebrew	Hebrejščina
Hindi	Hindujščina
Italian	Italijanščina
Japanese	Japonščina
Korean	Korejščina
Latin	Latinščina
Russian	Ruščina
Spanish	Španščina
Urdu	Urdujščina
Days	Dnevi
Monday	ponedeljek
Tuesday	torek
Wednesday	sreda
Thursday	četrtek
Friday	petek
Saturday	sobota
Sunday	nedelja
time	čas
hour	ura
minute	minuta
second	sekunda
colors	barve
black	črna
blue	modra
brown	rjava
gray	siva
green	zelena
orange	oranžna
purple	vijolična
red	rdeča
white	bela
yellow	rumena
sizes	velikosti
big	velik
deep	globok
long	dolg
narrow	ozek
short	kratek
small	majhen
tall	visok
thick	debel
thin	tanek
wide	širok
tastes	okusi
bitter	grenek
fresh	svež
salty	slan
sour	kisel
spicy	začinjen
sweet	sladek
qualities	lastnosti
bad	slab
clean	čist
dark	temen
difficult	težek
dirty	umazan
dry	suh
easy	enostaven
empty	prazen
expensive	drag
fast	hiter
foreign	tuj
full	poln
good	dober
hard	trd
heavy	težek
inexpensive	poceni
light	svetel
local	lokalen
new	nov
noisy	hrupen
old	star
powerful	močen
quiet	tih
correct	pravilen
slow	počasen
soft	mehek
very	zelo
weak	šibek
wet	moker
wrong	napačen
young	mlad
food	hrana
almonds	mandlji
bread	kruh
breakfast	zajtrk
butter	maslo
candy	bonboni
cheese	sir
chicken	piščanec
cumin	kumina
dessert	sladica
dinner	večerja
fish	ribe
fruit	sadje
ice cream	sladoled
lamb	jagnje
lemon	limona
lunch	kosilo
meal	obrok
meat	meso
oven	pečica
pepper	poper
plants	rastline
pork	svinjina
salad	solata
salt	sol
sandwich	sendvič
sausage	klobasa
soup	juha
sugar	sladkor
supper	večerja
turkey	puran
apple	jabolko
banana	banana
oranges	pomaranče
peaches	breskve
peanut	arašid
pears	hruške
pineapple	ananas
grapes	grozdje
strawberries	jagode
vegetables	zelenjava
carrot	korenček
corn	koruza
cucumber	kumara
garlic	česen
lettuce	zelena solata
olives	olive
onions	čebula
peppers	paprika
potatoes	krompir
pumpkin	buča
beans	fižol
tomatoes	paradižnik
alligator	aligator
alligators	aligatorji
bear	medved
bears	medvedi
bird	ptica
birds	ptice
bull	bik
bulls	biki
cat	mačka
cats	mačke
cow	krava
cows	krave
deer	srna
many deer	srne
dog	pes
dogs	psi
donkey	osel
donkeys	osli
eagle	orel
eagles	orli
elephant	slon
elephants	sloni
giraffe	žirafa
giraffes	žirafe
goat	koza
goats	koze
horse	konj
horses	konji
lion	lev
lions	levi
monkey	opica
monkeys	opice
mouse	miš
mice	miši
rabbit	zajec
rabbits	zajci
snake	kača
snakes	kače
tiger	tiger
tigers	tigri
wolf	volk
wolves	volkovi
objects	predmeti
bathroom	kopalnica
bed	postelja
bedroom	spalnica
ceiling	strop
chair	stol
clothes	oblačila
coat	plašč
cup	skodelica
desk	miza
dress	obleka
floor	tla
fork	vilice
furniture	pohištvo
glass	steklo
hat	klobuk
house	hiša
ink	črnilo
jacket	jakna
kitchen	kuhinja
knife	nož
lamp	svetilka
letter	pismo
map	zemljevid
newspaper	časopis
notebook	zvezek
pants	hlače
paper	papir
pen	pero
pencil	svinčnik
pharmacy	lekarna
picture	slika
plate	plošča
refrigerator	hladilnik
restaurant	restavracija
roof	streha
room	soba
rug	preproga
scissors	škarje
shampoo	šampon
shirt	srajca
shoes	čevlji
soap	milo
socks	nogavice
spoon	žlica
table	miza
toilet	stranišče
toothbrush	zobna ščetka
toothpaste	zobna pasta
towel	brisača
umbrella	dežnik
underwear	spodnje perilo
wall	stena
wallet	denarnica
window	okno
telephone	telefon
this	to
that	tisto
these	ti
those	tisti
Questions	
how?	kako?
what?	kaj?
who?	kdo?
why?	zakaj?
where?	kje?
different objects	različni predmeti
art	umetnost
bank	banka
beach	plaža
book	knjiga
by bicycle	s kolesom
by bus	z avtobusom
by car	z avtomobilom
by train	z vlakom
cafe	kavarna
country	država
desert	puščava
dictionary	slovar
earth	zemlja
flowers	cvetje
football	nogomet
forest	gozd
game	igra
garden	vrt
geography	geografija
history	zgodovina
house	hiša
island	otok
lake	jezero
library	knjižnica
math	matematika
moon	luna
mountain	gora
movies	filmi
music	glasba
ocean	ocean
office	pisarna
on foot	peš
player	igralec
river	reka
science	znanost
sea	morje
sky	nebo
soccer	nogomet
stars	zvezde
supermarket	veleblagovnica
swimming pool	bazen
theater	gledališče
tree	drevo
weather	vreme
bad weather	slabo vreme
cloudy	oblačno
cold	mrzlo
cool	hladno
foggy	megleno
hot	vroče
nice weather	lepo vreme
pouring	lije
rain	dež
raining	dežuje
snow	sneg
snowing	sneži
ice	led
sunny	sončno
windy	vetrovno
spring	pomlad
summer	poletje
autumn	jesen
winter	zima
people	ljudje
aunt	teta
baby	otrok
brother	brat
cousin	sestrična
daughter	hči
dentist	zobozdravnik
doctor	zdravnik
father	oče
grandfather	dedek
grandmother	babica
husband	mož
mother	mati
nephew	nečak
niece	nečakinja
nurse	medicinska sestra
policeman	policist
postman	poštar
professor	profesor
son	sin
teacher	učitelj
uncle	stric
wife	žena
Plural	Množina
my book	moja knjiga
my books	moje knjige
our daughter	naša hči
our daughters	naše hčere
I'm cold	Zebe me
we're cold	Zebe nas
his chickens	njegov piščanec
their chicken	njegovi piščanci
alligator	aligator
alligators	aligatorji
bear	medved
bears	medvedi
bird	ptič
birds	ptice
bull	bik
bulls	biki
cat	mačka
cats	mačke
cow	krava
cows	krave
deer	jelen/srna
many deer	srne
dog	pes
dogs	psi
donkey	osel
donkeys	osli
eagle	orel
eagles	orli
elephant	slon
elephants	sloni
giraffe	žirafa
giraffes	žirafe
goat	koza
goats	koze
horse	konj
horses	konji
lion	lev
lions	levi
monkey	opica
monkeys	opice
mouse	miš
mice	miši
rabbit	zajec
rabbits	zajci
snake	kača
snakes	kače
tiger	tiger
tigers	tigri
wolf	volk
wolves	volkovi
Negation	Zanikanje
he is not here	njega ni tukaj
that is not my book	to ni moja knjiga
do not enter	ne vstopaj/ne vstopajte
I don't speak	Jaz ne govorim
I don't write	Jaz ne pišem
I don't drive	Jaz ne vozim
I don't love	Jaz ne ljubim
I don't give	Jaz ne dajem
I don't smile	Jaz se ne smejim
I don't take	ne vzamem
he doesn't speak	on ne govori
he doesn't write	ne piše
he doesn't drive	on ne vozi
he doesn't love	on ne ljubi
he doesn't give	on ne daje
he doesn't smile	on se ne smeji
he doesn't take	on ne jemlje
we don't speak	mi ne govorimo
we don't write	mi ne pišemo
we don't drive	mi ne vozimo
we don't love	mi ne ljubimo
we don't give	mi ne dajemo
we don't smile	mi se ne smejimo
we don't take	mi ne jemljemo
Questions	Vprašanja
how?	kako?
what?	kaj?
who?	kdo?
why?	zakaj?
where?	kje?
where is he?	kje je on?
what is this?	kaj je to?
why are you sad?	zakaj si žalosten?
how do you want to pay?	Kako želite plačati?
can I come?	ali lahko pridem?
is he sleeping?	ali on spi?
do you know me?	me poznaš?
do you have my book?	imaš mojo knjigo?
how big is it?	kako velik je?/kako velika je?
can I help you?	Ti lahko pomagam?/Vam lahko pomagam?
can you help me?	Mi lahko pomagaš?/Mi lahko pomagate?
do you speak English?	Ali govoriš angleško?/Ali govorite angleško?
how far is this?	kako daleč je to?
what time is it?	koliko je ura?
how much is this?	koliko je to?
what is your name?	kako ti je ime?
where do you live?	kje živiš?
Pronouns	Zaimki
I	jaz
you	ti
he	on
she	ona
we	mi
they	oni/one
me	mene/me
you	tebe/te
him	njega
her	njo
us	nas
them	njim
my	moj
your	tvoj
his	njegov
her	njen
our	naš
their	njihov
mine	moje
yours	tvoje
his	njegovo
hers	njeno
ours	naše
theirs	njihovo
I speak	jaz govorim
you speak	ti govoriš
he speaks	on govori
she speaks	ona govori
we speak	mi govorimo
they speak	oni govorijo
give me	daj meni/daj mi
dam tebi/dam ti
give him	daj njemu
give her	daj njej
give us	daj nam
give them	daj njim
my book	moja knjiga
your book	tvoja knjiga
his book	njegova knjiga
her book	njena knjiga
our book	naša knjiga
their book	njihova knjiga
Verbs	Glagoli
Past	Preteklik
I spoke	govoril sem
I wrote	Pisal sem
I drove	vozil sem
I loved	ljubil sem
I gave	dal sem
I smiled	Nasmehnil sem se
I took	Vzel sem
he spoke	govoril je
he wrote	je pisal
he drove	vozil je
he loved	ljubil je
he gave	je dal
he smiled	se je nasmehnil
he took	je vzel
we spoke	smo govorili
we wrote	pisali smo
we drove	smo se vozili
we loved	ljubili smo
we gave	dali smo
we smiled	smo se nasmehnili
we took	smo vzeli
Future	Prihodnjik
I will speak	govoril bom
I will write	pisal bom
I will drive	Bom vozil
I will love	Bom ljubil
I will give	dal bom
I will smile	Se bom nasmehnil
I will take	Bom vzel
he will speak	govoril bo
he will write	on bo pisal
he will drive	on bo vozil
he will love	on bo ljubil
he will give	on bo dal
he will smile	on se bo nasmehnil
he will take	on bo vzel
we will speak	mi bomo govorili
we will write	mi bomo pisali
we will drive	mi bomo vozili
we will love	mi bomo ljubili
we will give	mi bomo dali
we will smile	mi se bomo nasmehnili
we will take	mi bomo vzeli
Present	Sedanjik
I speak	jaz govorim
I write	jaz pišem
I drive	jaz vozim
I love	jaz ljubim
I give	jaz dam
I smile	jaz se nasmehnem
I take	jaz vzamem
he speaks	on govori
he writes	on piše
he drives	on vozi
he loves	on ljubi
he gives	on daje
he smiles	on se nasmehne
he takes	on vzame
we speak	mi govorimo
we write	mi pišemo
we drive	mi vozimo
we love	mi imamo radi
we give	mi damo
we smile	mi se nasmehnemo
we take	mi vzamemo
I can accept that	jaz to lahko sprejmem
she added it	ona je to dodala
we admit it	mi priznamo
they advised him	oni so mu svetovali
I can agree with that	jaz se s tem lahko strinjam
she allows it	ona to dovoli
we announce it	mi to razglašamo
I can apologize	jaz se lahko opravičim
she appears today	ona se danes pojavi/ona se danes zdi
they arranged that	oni so to uredili
I can arrive tomorrow	jaz lahko pridem jutri
she can ask him	ona ga lahko vpraša
she attaches that	ona to priloži
we attack them	mi jih napadamo
they avoid her	oni se je izogibajo
I can bake it	jaz lahko to spečem
she is like him	ona je kot on
we beat it	mi to pretepamo
they became happy	oni so postali srečni
I can begin that	jaz lahko to začnem
we borrowed money	mi smo si izposodili denar
they breathe air	oni dihajo zrak
I can bring it	jaz lahko to prinesem
I can build that	jaz lahko to izgradim
she buys food	ona kupuje hrano
we calculate it	mi to preračunavamo
they carry it	oni to nosijo
they don't cheat	oni ne goljufajo
she chooses him	ona izbere njega
we close it	mi to zapremo
he comes here	on pride sem
I can compare that	jaz lahko to primerjam
she competes with me	ona tekmuje z mano
we complain about it	mi se pritožujemo nad tem
they continued reading	oni so nadaljevali z branjem
he cried about that	on je jokal zaradi tega
I can decide now	jaz se lahko sedaj odločim
she described it to me	ona je to meni opisala
we disagree about it	mi se o tem ne strinjamo
they disappeared quickly	oni so hitro izginili
I discovered that	jaz sem to odkril
she dislikes that	ona tega ne mara
we do it	mi to počnemo
they dream about it	oni o tem sanjajo
I earned	jaz sem zaslužil
he eats a lot	veliko poje
we enjoyed that	mi smo ob tem uživali
they entered here	oni so tu vstopili
he escaped that	on je temu pobegnil
I can explain that	jaz lahko to razložim
she feels that too	ona tudi to občuti
we fled from there	mi smo od tu zbežali
they will fly tomorrow	oni bodo jutri leteli
I can follow you	jaz ti lahko sledim
she forgot me	ona me je pozabila
we forgive him	mi mu oprostimo
I can give her that	jaz ji lahko to dam
she goes there	tja gre
we greeted them	mi smo jih pozdravili
I hate that	jaz to sovražim
I can hear it	jaz lahko to slišim
she imagine that	ona si to predstavlja
we invited them	mi smo jih povabili
I know him	jaz ga poznam
she learned it	ona se je to naučila
we leave now	mi sedaj odhajamo
they lied about him	oni so lagali o njem
I can listen to that	jaz lahko to poslušam
she lost that	ona je to izgubila
we made it yesterday	mi smo to naredili včeraj
they met him	oni so ga spoznali
I misspell that	jaz to napačno črkujem
I always pray	jaz vedno molim
she prefers that	ona ima to raje
we protected them	mi smo jih zaščitili
they will punish her	oni jo bodo kaznovali
I can put it there	jaz lahko to postavim tja
she will read it	ona bo to prebrala
we received that	mi smo to prejeli
they refuse to talk	oni ne želijo govoriti
I remember that	jaz se tega spominjam
she repeats that	ona to ponavlja
we see it	mi to vidimo
they sell it	oni to prodajajo
I sent that yesterday	jaz sem to poslal včeraj
he shaved his beard	on si je obril brado
it shrunk quickly	hitro se je skrčilo
we will sing it	mi bomo to zapeli
they sat there	oni so tam sedeli
I can speak it	jaz lahko to govorim
she spends money	ona zapravlja denar
we suffered from that	mi smo zaradi tega trpeli
they suggest that	oni so to predlagali
I surprised him	jaz sem ga presenetil
she took that	ona je to vzela
we teach it	mi to učimo
they told us	oni so nam povedali
she thanked him	ona se mu je zahvalila
I can think about it	jaz lahko o tem razmišljam
she threw it	ona je to vrgla
we understand that	mi to razumemo
they want that	oni to hočejo
I can wear it	jaz lahko to nosim
she writes that	ona to piše
we talk about it	mi o tem govorimo
they have it	oni to imajo
I watched it	jaz sem to gledal
I will talk about it	jaz bom o tem govoril
he bought that yesterday	jaz sem to kupil včeraj
we finished it	mi smo to končali
adverbs	prislovi
I read a book sometimes	Včasih berem knjigo
I will never smoke	Nikoli ne bom kadil
are you alone?	Si sam?/Ste sami?
adverbs of time	prislovi časa
yesterday	včeraj
today	danes
tomorrow	jutri
now	zdaj
then	nato
later	kasneje
tonight	nocoj
right now	takoj
last night	sinoči
this morning	to jutro
next week	naslednji teden
already	že
recently	pred kratkim
lately	zadnje čase
soon	kmalu
immediately	takoj
still	še vedno
yet	še
ago	nazaj
adverbs of place	prislovi kraja
here	tukaj
there	tam
over there	tam
everywhere	povsod
anywhere	kjerkoli
nowhere	nikjer
home	doma
away	stran
out	zunaj
adverbs of manner	prislovi načina
very	zelo
quite	precej
pretty	precej
really	res/resnično
fast	hitro
well	dobro
hard	trdo
quickly	hitro
slowly	počasi
carefully	skrbno
hardly	komaj
barely	komaj
mostly	večinoma
almost	skoraj
absolutely	povsem
together	skupaj
alone	samo
adverbs of frequency	prislovi pogostosti
always	vedno
frequently	pogosto
usually	navadno
sometimes	včasih
occasionally	občasno
seldom	redko
rarely	redko
never	nikoli
articles	členi
the	ta
a	neki
one	en
some	nekaj
few	malo
the book	knjiga (tista knjiga)
the books	te knjige
a book	knjiga (ena knjiga)
one book	ena knjiga
some books	nekaj knjig
few books	malo knjig
Food	hrana
almonds	mandlji
bread	kruh
breakfast	zajtrk
butter	maslo
candy	bonboni
cheese	sir
chicken	piščanec
cumin	kumina
dessert	sladica
dinner	večerja
fish	ribe
fruit	sadje
ice cream	sladoled
lamb	jagnje
lemon	limona
lunch	kosilo
meal	obrok
meat	meso
oven	pečica
pepper	poper
plants	rastline
pork	svinjina
salad	solata
salt	sol
sandwich	sendvič
sausage	klobasa
soup	juha
sugar	sladkor
supper	večerja
turkey	puran
apple	jabolko
banana	banana
oranges	pomaranče
peaches	breskve
peanut	arašid
pears	hruške
pineapple	ananas
grapes	grozdje
strawberries	jagode
vegetables	zelenjava
carrot	korenček
corn	koruza
cucumber	kumara
garlic	česen
lettuce	zelena solata
olives	olive
onions	čebule
peppers	paprika
potatoes	krompir
pumpkin	buča
beans	fižol
tomatoes	paradižnik
Feminine	Ženski spol
he is happy	srečen je
she is happy	srečna je
he is American	on je Američan
she is American	ona je Američanka
man	moški
woman	ženska
father	oče
mother	mati
brother	brat
sister	sestra
uncle	stric
aunt	teta
bull	bik
cow	krava
boy	fant
girl	dekle
objects	predmeti
bathroom	kopalnica
bed	postelja
bedroom	spalnica
ceiling	strop
chair	stol
clothes	oblačila
coat	plašč
cup	skodelica
desk	miza
dress	obleka
floor	tla
fork	vilice
furniture	pohištvo
glass	kozarec
hat	klobuk
house	hiša
ink	črnilo
jacket	jakna
kitchen	kuhinja
knife	nož
lamp	svetilka
letter	pismo
map	zemljevid
newspaper	časopis
notebook	zvezek
pants	hlače
paper	papir
pen	pero
pencil	svinčnik
pharmacy	lekarna
picture	slika
plate	krožnik
refrigerator	hladilnik
restaurant	restavracija
roof	streha
room	soba
rug	preproga
scissors	škarje
shampoo	šampon
shirt	srajca
shoes	čevlji
soap	milo
socks	nogavice
spoon	žlica
table	tabela
toilet	stranišče
toothbrush	zobna ščetka
toothpaste	zobna pasta
towel	brisača
umbrella	dežnik
underwear	spodnje perilo
wall	stena
wallet	denarnica
window	okno
telephone	telefon
be	biti
have	imeti
do	naredi
would	bi
will	volja
can	lahko
know	vem
see	glej
may	maja
should	bi morali
get	dobili
think	pomisli
go	pojdi
make	naredite
must	mora
take	vzemite
come	pridi
say	recimo
put	dal
want	želim
give	dajte
look	poglej
find	najti
need	potrebujejo
like	všeč
set	nastavite
use	uporaba
become	postati
tell	povej
keep	obdrži
help	pomoč
work	delo
let	pustiti
feel	čutiti
provide	zagotoviti
believe	verjeti
try	poskusite
shall	mora
ask	vprašajte
remember	ne pozabite
leave	dopusti
show	oddaja
pay	plačati
run	teči
read	preberite
seem	zdi se
include	vključujejo
bring	prinesi
understand	razumeti
start	začetek
play	igra
cut	rez
live	v živo
meet	srečati
move	premakniti
hear	sliši
call	pokličite
stop	ustavi se
turn	obrat
talk	pogovor
buy	kupi
thank	hvala
change	spremembe
continue	nadaljujte
consider	razmislite
allow	dovolite
hope	upanje
produce	proizvajajo
stay	ostani
appear	se pojavijo
write	piši
hold	počakajte
expect	pričakovati
ensure	zagotoviti
suppose	domnevam
wish	želja
carry	nositi
follow	sledite
offer	ponudbo
support	podporo
accept	sprejeti
speak	govoriti
lead	svinec
remain	ostanejo
stand	stojalo
suggest	predlagam
hit	zadeti
develop	razvijati
happen	zgodilo
sit	sedi
win	zmaga
love	ljubezen
add	dodaj
learn	nauči se
create	ustvariti
let	pustiti
agree	strinjam se
apply	prijaviti
wait	počakaj
avoid	izogibajte se
send	pošlji
form	oblika
explain	razloži
return	vrnitev
sell	prodati
receive	prejeti
open	odprto
begin	začeti
eat	jejte
increase	porast
voice	glas
spend	porabiti
join	pridruži se
reduce	zmanjšati
save	shrani
require	zahtevajo
fall	padec
mind	um
build	graditi
achieve	doseči
choose	izberite
prevent	preprečiti
reach	doseči
decide	odločite se
deal	dogovoriti
face	obraz
enjoy	uživajte
watch	pazi
lose	izgubiti
walk	hodi
cover	pokrov
improve	izboljšati
tend	nagibati se
raise	dvigniti
draw	žrebanje
forget	pozabi
imagine	predstavljajte si
act	deluje
pick	izberite
cause	vzrok
cost	stroškov
pass	podajo
break	odmor
prove	dokazati
occur	pojavijo
discuss	razpravljati
listen	poslušaj
maintain	vzdrževati
end	konec
exist	obstajajo
seek	iskati
grow	rastejo
check	preverite
serve	služijo
share	deliti
establish	vzpostaviti
enter	vnesite
control	nadzor
die	umreti
encourage	spodbujati
answer	odgovor
protect	zaščititi
identify	prepoznati
visit	obisk
care	nego
enable	omogoči
affect	vplivajo
claim	terjatev
note	Opomba
obtain	pridobiti
represent	predstavljajo
contain	vsebujejo
beat	premagati
spread	širjenje
worry	skrbi
bear	medved
shut	zaprti
wonder	čudim se
afford	privoščite si
fit	fit
kill	ubiti
regard	upoštevati
describe	opiši
place	kraj
drive	pogon
wear	obraba
argue	trditi
involve	vključujejo
lie	lagati
contact	stik
catch	ulov
assume	predpostavimo
indicate	navedite
operate	delujejo
manage	upravljati
cope	spoprijeti
remove	Odstrani
determine	določiti
fight	boj
pull	potegnite
realise	zavedati se
reflect	odražajo
fill	napolnite
refer	napoti
gain	dobiček
examine	preučiti
prefer	raje
travel	potovanja
admit	priznati
recognise	prepoznati
attend	udeležiti se
hurt	poškodovan
respond	odgovorite
sleep	spanje
introduce	uvesti
depend	odvisni
survive	preživeti
suffer	trpeti
notice	opaziti
close	blizu
result	rezultat
replace	zamenjati
complete	popolna
miss	zgrešiti
rise	vzpon
present	prisoten
arise	nastanejo
point	točka
fail	ne uspe
promote	promovirati
perform	izvesti
discover	odkrijte
express	izraziti
extend	podaljšati
drink	pijačo
mention	omeniti
vary	se razlikujejo
concentrate	osredotočiti
benefit	korist
treat	zdravljenje
hang	visi
throw	vrgel
prepare	pripravi
drop	padec
study	študij
push	potisnite
press	pritisnite
report	poročilo
cast	igralska zasedba
arrive	prispejo
sound	zvok
finish	konča
ring	prstan
test	preskus
secure	varno
collect	zbirati
escape	pobeg
teach	poučevati
last	zadnji
welcome	dobrodošli
rely	zanašati se
trust	zaupanje
match	tekmo
assess	ocenite
contribute	prispevati
repeat	ponovite
supply	ponudbe
wan	wan
plan	načrt
reveal	razkriti
state	država
confirm	potrdite
appreciate	cenim
hate	sovraštvo
relate	povezati
overcome	premagati
rid	znebiti
marry	poročiti
attempt	poskus
retain	obdrži
handle	ročaj
attract	privabiti
assist	pomagati
influence	vpliv
mark	oznaka
split	razcepljen
experience	izkušnje
recall	odpoklic
adopt	sprejeti
sign	znak
touch	dotik
fear	strah
stick	palico
settle	poravnati
ignore	prezreti
compare	primerjaj
define	opredeliti
exercise	vadba
demonstrate	demonstrirati
account	račun
persuade	prepričati
investigate	preiskati
clear	jasno
guess	ugibati
record	zapis
vote	glasovati
explore	raziskovati
blame	krivda
arrange	urediti
cross	križ
deny	zanikati
realize	zavedati se
hide	skrij
focus	osredotočiti
deliver	dostavi
proceed	nadaljujte
succeed	uspeti
bother	moti
refuse	zavrniti
force	sila
demand	povpraševanje
recognize	prepoznati
count	štetje
doubt	dvom
reckon	računati
belong	pripadajo
emerge	pojavijo
sing	pojejo
intend	nameravam
justify	utemelji
in	v
advise	svetovati
defend	braniti
laugh	smeh
dare	upam si
acquire	pridobiti
recover	si opomore
generate	ustvari
distinguish	razlikovati
suspect	osumljenec
earn	zaslužiti
finance	financ
bet	stava
destroy	uničiti
rest	počitek
judge	sodnik
pursue	zasledovati
comment	komentar
satisfy	zadovoljiti
compete	tekmovati
resist	upreti se
suit	obleko
address	naslov
solve	rešiti
lift	dvig
alter	spreminjati
impose	vsiliti
display	zaslon
appeal	pritožba
release	sprostitev
sort	razvrsti
differ	razlikujejo
select	izberite
measure	ukrep
recommend	priporočam
order	naročilo
transfer	prenos
attack	napad
expand	razširiti
roll	zvitek
burst	izbruh
undertake	se lotiti
relax	sprostite se
participate	sodelujejo
of	od
behave	obnašati se
strike	stavka
remind	opomni
review	pregled
approach	pristop
employ	zaposliti
restore	obnoviti
wash	pranje
observe	opazujte
combine	kombinirati
insist	vztrajati
issue	težava
ride	vožnja
constitute	predstavljajo
jump	skok
cook	kuhati
switch	stikalo
train	vlak
cry	jokati
clean	čisto
invest	vlagati
step	korak
limit	meja
illustrate	ponazoriti
own	lastno
tackle	reševanje
challenge	izziv
view	pogled
withdraw	dvigniti
possess	posedovati
communicate	komunicirati
climb	vzpon
gather	zbrati
separate	ločeno
preserve	ohraniti
implement	izvajati
shift	premik
resolve	rešiti
reject	zavrni
inform	obvestiti
imply	pomenijo
acknowledge	priznati
conclude	zaključiti
shoot	ustrelil
guarantee	garancija
comply	izpolnjujejo
borrow	sposoditi si
question	vprašanje
promise	obljubi
enhance	izboljšati
monitor	monitor
risk	tveganje
permit	dovoljenje
purchase	nakup
propose	predlagati
celebrate	praznovati
charge	napolniti
research	raziskave
aim	meriti
accommodate	prilagoditi
phone	telefon
waste	odpadki
dance	ples
wake	zbudi se
pray	moli
disappear	izginejo
telephone	telefon
predict	napovedovati
score	rezultat
slip	zdrs
commit	zavezati
complain	pritožba
detect	zaznati
exclude	izključi
excuse	izgovor
interpret	razlagati
publish	objavi
link	povezava
forgive	odpusti
negotiate	pogajati se
analyse	analizirati
name	ime
stretch	raztegniti
upset	razburjen
qualify	kvalificirati
damage	škodo
launch	kosilo
paint	barva
specify	navedite
grant	nepovratna sredstva
lend	posojati
construct	konstruirati
react	reagirati
organise	organizirati
deserve	zaslužijo
head	glavo
direct	neposredno
land	zemljišča
conduct	ravnanje
sustain	vzdrževati
submit	oddajte
consist	sestavljen
blow	udarec
mix	premešajte
guide	vodnik
owe	dolgujem
convince	prepričati
practise	praksa
strengthen	okrepiti
knock	potrkajte
invite	povabi
burn	opeklina
abandon	opustiti
reply	odgovor
shake	pretresemo
fix	popraviti
pretend	pretvarjati se
consult	posvetujte se
divide	razdeli
engage	vključiti
search	Iskanje
fulfil	izpolni
exploit	izkoriščati
rule	pravilo
process	proces
fetch	prinesi
convey	posredovati
shed	lopa
market	trgu
fancy	fancy
smoke	dim
smell	vonj
thrust	potisk
incorporate	vključiti
restrict	omeji
warn	opozori
eliminate	odpraviti
kiss	poljub
announce	objavi
evaluate	oceniti
convert	Pretvorba
retire	upokojiti
adjust	prilagodite
ease	lahkotnost
breathe	dihati
pour	nalij
knit	plesti
exceed	preseči
back	nazaj
approve	odobriti
trace	sled
register	register
calculate	izračunajte
occupy	zasedejo
stimulate	spodbujajo
print	natisni
stress	stres
appoint	imenovati
free	prost
interfere	motijo
object	predmet
boost	pospešek
smile	nasmeh
facilitate	olajšati
lack	pomanjkanje
cease	prenehati
enforce	uveljaviti
adapt	prilagoditi
tie	kravata
quote	kvota
dominate	prevladujejo
pop	pop
please	prosim
design	oblikovanje
intervene	posredovati
yield	donos
resign	odstopiti
spell	urok
shout	kričati
stir	premešajte
emphasise	poudariti
spare	rezervne
estimate	oceno
kick	brcnite
regret	obžalovanje
offset	odmik
list	seznam
dress	obleko
declare	izjavi
assure	zagotovim
derive	izpeljati
access	dostop
delay	zamuda
clarify	razjasniti
copy	kopirati
favour	naklonjenost
dig	kopati
respect	spoštovanje
hand	roka
capture	zajemanje
reinforce	okrepiti
transform	preoblikovati
perceive	zaznati
function	funkcijo
fuck	hudiča
threaten	grozi
quit	prenehati
accompany	spremljati
swim	plavati
fund	sklad
pack	paket
correct	pravilno
cancel	prekliči
sail	jadra
compensate	nadomestilo
steal	ukrasti
undermine	spodkopati
range	obseg
feature	funkcija
oppose	nasprotovati
locate	poiščite
hurry	pohiti
tap	tapnite
broadcast	oddaja
sue	tožiti
store	trgovina
trade	trgovina
bid	ponudba
organize	organizirati
light	svetloba
slow	počasi
concern	skrb
dismiss	odpustiti
swear	Preklinjati
highlight	poudarite
repair	popravilo
conform	skladen
amount	znesek
attach	pritrdite
dream	sanje
rush	hitenje
absorb	absorbirajo
sink	umivalnik
grab	zgrabi
calm	mirno
protest	protest
balance	ravnovesje
beg	prositi
install	namestite
advance	vnaprej
fire	ogenj
block	blok
aid	pomoč
flow	pretok
drag	povlecite
correspond	ustrezajo
pose	predstavljajo
admire	občudovati
relieve	razbremeniti
reverse	vzvratno
time	čas
combat	boj
integrate	vključiti
disagree	ne strinjam se
connect	povezati
update	nadgradnja
modify	spremeniti
anticipate	predvideti
tax	davek
opt	opt
stare	buljiti
spot	spot
command	ukaz
obey	ubogati
house	hiša
extract	izvleček
slide	zdrs
counter	števec
resume	Nadaljuj
grasp	prijem
swing	gugalnica
render	upodabljanje
speed	hitrost
confront	soočiti
ban	prepoved
wipe	obrišite
double	dvojno
comprise	obsegajo
witness	priča
plant	rastlina
breed	pasme
assert	trditi
disclose	razkriti
defeat	poraz
squeeze	stisnite
taste	okus
bind	vezati
harm	škodo
encounter	srečanje
request	prošnja
struggle	boj
hire	najem
conceal	prikriti
recruit	novačiti
co	co
wander	tavajo
emphasize	poudariti
weigh	tehtati
coincide	sovpadajo
bend	upognite se
regulate	urejajo
rescue	reševanje
entertain	zabavati
forecast	napoved
inspect	pregledati
export	izvoz
urge	nagona
induce	inducirati
lock	zaklepanje
exhibit	razstaviti
exchange	izmenjava
warm	toplo
confess	priznaj
tolerate	prenašati
mount	nosilec
brush	krtačo
reproduce	razmnožujejo
undergo	opraviti
impress	navdušiti
figure	slika
decline	upadanje
rub	vtrite
cater	poskrbi
tour	ogled
distribute	distribuirati
sense	smisel
repay	odplačati
regain	ponovno pridobiti
minimise	minimizirati
halt	ustavi
shape	obliko
cool	kul
disturb	moti
bite	ugriz
progress	napredek
devote	posvetiti
provoke	izzvati
dispose	razpolagati
translate	prevesti
reassure	pomirite
contemplate	razmišljati
alert	opozorilo
service	storitev
interact	interakcijo
heat	toplota
devise	zasnovati
govern	vladati
apologise	opraviči se
expose	izpostavi
embrace	objem
comfort	udobje
seize	zaseči
melt	stopi
supplement	dodatek
lean	vitka
exert	izvajati
beware	pozor
resemble	spominjajo
abolish	ukiniti
wed	sre
arrest	aretirati
crack	razpoka
suppress	zatreti
guard	stražar
surprise	presenečenje
hesitate	oklevajte
load	obremenitev
swallow	pogoltniti
initiate	inicirati
float	float
effect	učinek
manipulate	manipulirati
deter	odvrniti
associate	sodelavec
administer	dajati
murder	umor
persist	vztrajajo
greet	pozdravi
tear	trgati
hunt	lov
spoil	pokvariti
line	črta
bless	blagoslovi
ascertain	ugotoviti
penetrate	prodreti
multiply	pomnožite
merge	združiti
coach	trener
drain	odtok
suffice	zadostuje
presume	domnevati
fish	ribe
shop	trgovina
race	dirka
honour	čast
freeze	zamrzne
cure	zdravi
revive	oživiti
swap	zamenjati
endure	prenašati
chase	lov
consume	porabijo
insert	vstavi
anger	jeza
await	čakati
minister	minister
drift	odnašanje
substitute	nadomestek
stem	steblo
surrender	predaja
wind	veter
contract	pogodbe
machine	stroj
differentiate	razlikovati
advertise	oglaševati
reconcile	uskladiti
project	projekt
co	co
snap	snap
damn	prekleto
bake	speči
top	vrh
fold	krat
concede	priznati
renew	obnovi
formulate	formulirati
confuse	zmede
maximise	maksimirati
sweep	pometanje
cheer	navijati
steer	usmerjati
base	osnova
cf	prim
indulge	prepustite se
decrease	zmanjšanje
reserve	rezerve
host	gostitelj
evolve	razvijati
foster	negovati
discourage	malodušje
curb	robnik
allocate	dodeliti
supervise	nadzirati
fade	zbledi
endorse	potrditi
condemn	obsoditi
book	knjigo
tip	nasvet
reform	reforma
complement	dopolnilo
punish	kaznovati
bang	pok
outline	oris
diminish	zmanjšati
prevail	prevladajo
leap	preskok
wrap	zaviti
compromise	kompromis
collapse	propad
safeguard	zaščitni ukrep
inhibit	zavirati
scream	krik
date	datum
delete	izbriši
attain	doseči
dislike	ne maram
conceive	zanositi
shine	sijaj
dictate	narekujejo
unite	združiti
import	uvoz
spring	pomlad
rebuild	obnoviti
flourish	cvetijo
criticise	kritizirati
boil	zavremo
flee	beži
commence	začeti
praise	pohvala
draft	osnutek
park	parkirati
discriminate	diskriminirati
track	skladbo
enclose	priložiti
interview	intervju
tighten	zategnite
price	cena
colour	barva
venture	podviga
speculate	špekulirati
depart	odhod
bury	pokopljemo
interrupt	prekiniti
disguise	preobleko
elect	izvoljen
withstand	vzdržati
discharge	praznjenje
restrain	zadrževati
thrive	uspevajo
echo	odmev
divert	preusmeritev
fry	ocvrt
dissolve	raztopi
edit	Uredi
assemble	sestaviti
ruin	propad
accelerate	pospeši
envisage	predvideti
congratulate	čestitam
retrieve	pridobiti
descend	spustite se
suspend	začasno ustavi
experiment	poskus
ship	ladja
frighten	prestrašiti
fool	norec
inspire	navdihujejo
heal	ozdravi
master	mojster
terminate	prenehati
amend	spremeniti
scratch	praska
embark	vkrcati se
entail	pomenijo
execute	izvršiti
consolidate	utrditi
cash	gotovino
round	okrogla
isolate	izolirati
warrant	nalog
signal	signal
weaken	oslabiti
pin	pin
march	marec
desire	želja
widen	razširiti
level	ravni
chat	klepet
board	deska
contend	trditi
invent	izumiti
resource	vir
manufacture	proizvodnjo
seal	pečat
reconsider	premisliti
suck	zanič
picture	slika
crash	strmoglavljenje
transport	prevoz
plug	vtič
assign	dodeliti
enquire	povprašajte
campaign	kampanja
trap	past
surround	obkrožiti
debate	razprava
upgrade	nadgradnja
decorate	okrasite
confer	se posvetujejo
accumulate	kopičijo
profit	dobiček
file	mapa
inherit	podedovati
disrupt	motijo
contrast	kontrast
chuck	chuck
tick	kljukico
plead	tožba
dip	dip
subscribe	naročite se
educate	izobraževati
divorce	ločitev
spin	vrtenje
row	vrstici
obscure	nejasna
creep	lezenje
interest	obresti
overlook	spregledati
twist	zasuk
mature	zrel
blend	mešanica
revise	revidirati
attribute	atribut
explode	eksplodirajo
dwell	prebivati
drown	utopiti
alleviate	ublažiti
strip	trak
grade	razred
revert	povrniti
value	vrednost
award	nagrada
strive	prizadevati si
notify	obvestiti
remedy	pravno sredstvo
accuse	obtožiti
instruct	poučiti
spill	razlitje
strain	obremenitev
comprehend	razumeti
soften	zmehčajte
postpone	odložiti
wave	val
bounce	odbijanje
stock	zaloga
position	položaj
insure	zavarovati
adhere	držijo
cling	drži se
summon	priklicati
pause	pavza
empty	prazno
classify	razvrsti